11110011
1E00P001
00000001
10C00C01
11111111