1111111
1000001
111E001
1000P01
1111111